{
    "grid-0-0": [
        "...3.0....G",
        ".333.0.....",
        ".....00.444",
        "6....#..4..",
        "6....#.....",
        "6..#####...",
        "6....#.....",
        "..1..#.2...",
        "111..222...",
        "..........5",
        "S.......555"
    ],
    "grid-1-0": [
        "66..4444..G",
        "6..........",
        "6..........",
        ".....#.....",
        "..22.#.333.",
        "..2#####.3.",
        "5.2..#.....",
        "5....#.....",
        "55........1",
        "0000......1",
        "S........11"
    ],
    "grid-2-0": [
        "G.44.333...",
        "..4....3..5",
        "..4.......5",
        ".....#....5",
        "..0..#....5",
        "000#####...",
        ".111.#.....",
        "...1.#..222",
        "........2..",
        "...........",
        "S...6666..."
    ],
    "grid-3-0": [
        "..11..0...G",
        "...1..0....",
        "...1..0..4.",
        ".2...#0444.",
        ".2...#.....",
        ".22#####.33",
        "....6#....3",
        "....6#....3",
        "....66..555",
        "..........5",
        "S.........."
    ],
    "grid-4-0": [
        "G.......666",
        "...44.....6",
        "...4.....55",
        "...4.#...5.",
        "000..#...5.",
        "..0#####...",
        ".....#.2...",
        "...3.#.222.",
        ".333.......",
        "......1....",
        "S.....111.."
    ],
    "grid-5-0": [
        ".6666.0...G",
        "......0.555",
        ".....00.5..",
        ".111.#.....",
        "...1.#.....",
        "2..#####...",
        "2....#....4",
        "22...#.3444",
        ".......3...",
        "......33...",
        "S.........."
    ],
    "grid-6-0": [
        "..222G..555",
        "..2......5.",
        "....66.....",
        "....6#.....",
        "000.6#.....",
        "..0#####.44",
        ".....#....4",
        "...1.#....4",
        ".111.......",
        "..........3",
        "S.......333"
    ],
    "grid-7-0": [
        "444..G..555",
        ".4........5",
        "........111",
        "666..#....1",
        "6....#.....",
        "...#####000",
        ".....#....0",
        ".22..#.....",
        ".2........3",
        ".2........3",
        ".....S...33"
    ],
    "grid-8-0": [
        "55...444000",
        "5....4..0..",
        "5.G........",
        ".....#.....",
        "11...#..222",
        "1..#####2..",
        "1....#....3",
        "666..#....3",
        "6........33",
        "...........",
        "..........S"
    ],
    "grid-9-0": [
        "..........G",
        "..33.......",
        "...3444....",
        "22.3.#4....",
        ".2...#.....",
        ".2.#####555",
        ".....#0...5",
        "66...#0....",
        ".6....00...",
        ".6........1",
        "S.......111"
    ],
    "grid-10-0": [
        "000.......G",
        ".0........6",
        ".....555..6",
        ".....#.5.66",
        "..1..#.....",
        "..1#####222",
        ".11..#....2",
        ".....#.33..",
        "........3..",
        "....4...3..",
        "S.444......"
    ],
    "grid-11-0": [
        "..444.....G",
        "....4.....6",
        "..3.......6",
        "..333#...66",
        ".....#....2",
        ".00#####..2",
        "..0..#...22",
        "..0..#.....",
        ".....1....5",
        ".....1..555",
        "S....11...."
    ]
}