{
   "grid-12":[
      ".........3..G",
      ".........3...",
      ".........3...",
      "......#..3...",
      ".4....#......",
      ".4....#......",
      ".44#######...",
      "......#......",
      "...22.#.11...",
      "..22..#..1...",
      "......0..1...",
      "......0......",
      "S.....00....."
   ],
   "grid-13":[
      "..........4.G",
      "..........4..",
      ".........44..",
      "......#......",
      ".333..#......",
      "...3..#......",
      "...#######...",
      "......#......",
      "...1..#.2....",
      "..111.#.22...",
      "......0..2...",
      "......00.....",
      "S......0....."
   ],
   "grid-14":[
      "111......4..G",
      ".1.......4...",
      "........44...",
      "......#......",
      "......#......",
      "......#......",
      "...#######0..",
      "3.....#...000",
      "333...#22....",
      "......#.22...",
      ".............",
      ".............",
      "S............"
   ],
   "grid-15":[
      "222.......4.G",
      "2.........4..",
      ".........44..",
      "......#......",
      "......#......",
      "......#......",
      "...#######...",
      "......#..0000",
      "3333..#......",
      "......#......",
      ".............",
      ".........11..",
      "S.........11."
   ]
}
